20
10
GGGGGGGGGGGGGGGGGGGG
GGGGGPPPPPPPPPPPPPPB
GGGGGPGGGGGGGGGGGGGG
GGGGGPGGGGGGGGGGGGGG
GGGGGPPPPPPPPPPPPGGG
GGGGGGGGGGGGGGGGPGGG
GGGGGGGGGGGGGGGGPGGG
GGGGGGGGGGGGGGGGPGGG
PPPPPPPPPPPPPPPPPGGG
GGGGGGGGGGGGGGGGGGGG
