20
20
GGGGGGGGGGGGGGGGGGGG
GGGGGGGGGGGGGGGGGGGG
PPPPPGGGGGGPPGGGGGGG
GGGPPPPPGGPPPPGGGGGG
GGGPPPPPPPPGGPPPPPPP
GGGGGGGGPGGGGGGGGPPP
PPPGGGGGGGGGGGGPPPGG
GGPPPGGGGGGGGPPPGGGG
GGGGPPPPGGGGPPGGGGGG
GGGGGGGPPGGPPGGGGGGG
GGGGGGGGPPPPGGGGGGGG
GGGGGGGGGGGGGGGGGGGG
GGGGGGGGGGGGGGGGGGGG
GGGGPPPPPGGGGGGPPPPP
GGPPPGGGPPPGGGGPPGGG
PPPGGGGGGGPPPGGPPGGG
GGGGGGGPGGPPPPPPPGGG
GGGGPPPPPPPGGGGGGGGG
GGGPPGGGGGGGGGGGGGGG
GGGPPGGGGGGGGGGGGGGG
